E E E E E E E E E E E E E E E E E E E E E E E E E E E E E ?
E E E E E E E E E E E E E E E E E E E E E E E E E E E E E ?
E E E E E E E E E E E E E E E E E E E E E E E E E E E E E ?
E W W W W W W W W W W W W W W W W W W W W W W W W W W W W ?
E W B B B B B B B B B B B B W W B B B B B B B B B B B B W ?
E W B W W W W B W W W W W B W W B W W W W W B W W W W B W ?
E W B W W W W B W W W W W B W W B W W W W W B W W W W B W ?
E W S W W W W B W W W W W B W W B W W W W W B W W W W S W ?
E W B B B B B B B B B B B B B B B B B B B B B B B B B B W ?
E W B W W W W B W W B W W W W W W W W B W W B W W W W B W ?
E W B W W W W B W W B W W W W W W W W B W W B W W W W B W ?
E W B B B B B B W W B B B B W W B B B B W W B B B B B B W ?
E W W W W W W B W W W W W B W W B W W W W W B W W W W W W ?
E E E E E E W B W W W W W B W W B W W W W W B W E E E E E ?
E E E E E E W B W W E E E E E E E E E E W W B W E E E E E ?
E E E E E E W B W W E W W W E E W W W E W W B W E E E E E ?
E W W W W W W B W W E W E E E E E E W E W W B W W W W W W ?
E E E E E E E B E E E W E 1 E E E E W E E E B E E E E E E ?
E W W W W W W B W W E W E E 2 E E E W E W W B W W W W W W ?
E E E E E E W B W W E W W W W W W W W E W W B W E E E E E ?
E E E E E E W B W W E E E E E E E E E E W W B W E E E E E ?
E E E E E E W B W W E W W W W W W W W E W W B W E E E E E ?
E W W W W W W B W W E W W W W W W W W E W W B W W W W W W ?
E W B B B B B B B B B B B B W W B B B B B B B B B B B B W ?
E W B W W W W B W W W W W B W W B W W W W W B W W W W B W ?
E W B W W W W B W W W W W B W W B W W W W W B W W W W B W ?
E W S B B W W B B B B B B B P B B B B B B B B W W B B S W ?
E W W W B W W B W W B W W W W W W W W B W W B W W B W W W ?
E W W W B W W B W W B W W W W W W W W B W W B W W B W W W ?
E W B B B B B B W W B B B B W W B B B B W W B B B B B B W ?
E W B W W W W W W W W W W B W W B W W W W W W W W W W B W ?
E W B W W W W W W W W W W B W W B W W W W W W W W W W B W ?
E W B B B B B B B B B B B B B B B B B B B B B B B B B B W ?
E W W W W W W W W W W W W W W W W W W W W W W W W W W W W ?
E E E E E E E E E E E E E E E E E E E E E E E E E E E E E ?
E E E E E E E E E E E E E E E E E E E E E E E E E E E E E ?