E E E E E E E E E E E E E E E E E E E E E E E E E E E E ?
E E E E E E E E E E E E E E E E E E E E E E E E E E E E ?
E E E E E E E E E E E E E E E E E E E E E E E E E E E E ?
W W W W W W W W W W W W W W W W W W W W W W W W W W W W ?
W B B B B B B B B B W W B B B B W W B B B B B B B B B W ?
W B W W W W B W W B W W B W W B W W B W W B W W W W B W ?
W B W W W W B W W B W W B W W B W W B W W B W W W W B W ?
W B B B B S B W W B B B B W W B B B B W W B S B B B B W ?
W B W W W W B W W W W W B W W B W W W W W B W W W W B W ?
W B W W W W B W W W W W B W W B W W W W W B W W W W B W ?
W B W W B B B B B B B B B W W B B B B B B B B B W W B W ?
W B W W B W W W W E W W W W W W W W E W W W W B W W B W ?
W B W W B W W W W E W W W W W W W W E W W W W B W W B W ?
E B B B B B B E E E E E E E E E E E E E E B B B B B B E ?
W B W W W W B W W E W W W E E W W W E W W B W W W W B W ?
W B W W W W B W W E W E E E E E E W E W W B W W W W B W ?
W B W W W W B W W E W E 1 E E E E W E W W B W W W W B W ?
W B B B B B B W W E W E E 2 E E E W E W W B B B B B B W ?
W E W W W W B W W E W W W W W W W W E W W B W W W W E W ?
W E W W W W B W W E E E E E E E E E E W W B W W W W E W ?
W E E E W W B W W E W W W W W W W W E W W B W W E E E W ?
W W W E W W B B B B B B B W W B B B B B B B W W E W W W ?
W W W E W W B W W W W W B W W B W W W W W B W W E W W W ?
E E E E W W B W W W W W B W W B W W W W W B W W E E E E ?
W E W W W W B W W B B B B P E B B B B W W B W W W W E W ?
W E W W W W B W W B W W B W W B W W B W W B W W W W E W ?
W B B B B B B W W B W W B W W B W W B W W B B B B B B W ?
W B W W B W W W W B W W B W W B W W B W W W W B W W B W ?
W B W W B W W W W B W W B W W B W W B W W W W B W W B W ?
W B W W B S B B B B W W B B B B W W B B B B S B W W B W ?
W B W W W W W W W B W W W W W W W W B W W W W W W W B W ?
W B W W W W W W W B W W W W W W W W B W W W W W W W B W ?
W B B B B B B B B B B B B B B B B B B B B B B B B B B W ?
W W W W W W W W W W W W W W W W W W W W W W W W W W W W ?
E E E E E E E E E E E E E E E E E E E E E E E E E E E E ?
E E E E E E E E E E E E E E E E E E E E E E E E E E E E ?