E E E E E E E E E E E E E E E E E E E E E E E E E E E E E ?
E E E E E E E E E E E E E E E E E E E E E E E E E E E E E ?
E E E E E E E E E E E E E E E E E E E E E E E E E E E E E ?
E E E E E E E E E E E E E E E E E E E E E E E E E E E E E ?
E R H H H H H H H H H H H H L R H H H H H H H H H H H H L ?
E V B B B B B B B B B B B B V V B B B B B B B B B B B B V ?
E V B R H H L B R H H H L B V V B R H H H L B R H H L B V ?
E V B V E E V B V E E E V B V V B V E E E V B V E E V B V ?
E V S D H H U B D H H H U B D U B D H H H U B D H H U S V ?
E V B B B B B B B B B B B B B B B B B B B B B B B B B B V ?
E V B R H H L B R L B R H H H H H H L B R L B R H H L B V ?
E V B D H H U B V V B D H H L R H H U B V V B D H H U B V ?
E V B B B B B B V V B B B B V V B B B B V V B B B B B B V ?
E D H H H H L B V D H H L B V V B R H H U V B R H H H H U ?
E E E E E E V B V R H H U B D U B D H H L V B V E E E E E ?
E E E E E E V B V V E E E E E E E E E E V V B V E E E E E ?
E E E E E E V B V V E R H H E E H H L E V V B V E E E E E ?
E H H H H H U B D U E V E E E E E E V E D U B D H H H H H ?
E E E E E E E B E E E V E E 1 2 E E V E E E B E E E E E E ?
E H H H H H L B R L E V E E 3 E E E V E R L B R H H H H H ?
E E E E E E V B V V E D H H H H H H U E V V B V E E E E E ?
E E E E E E V B V V E E E E F E E E E E V V B V E E E E E ?
E E E E E E V B V V E R H H H H H H L E V V B V E E E E E ?
E R H H H H U B D U E D H H L R H H U E D U B D H H H H L ?
E V B B B B B B B B B B B B V V B B B B B B B B B B B B V ?
E V B R H H L B R H H H L B V V B R H H H L B R H H L B V ?
E V B D H L V B D H H H U B D U B D H H H U B V R H U B V ?
E V S B B V V B B B B B B B P B B B B B B B B V V B B S V ?
E D H L B V V B R L B R H H H H H H L B R L B V V B R H U ?
E R H U B D U B V V B D H H L R H H U B V V B D U B D H L ?
E V B B B B B B V V B B B B V V B B B B V V B B B B B B V ?
E V B R H H H H U D H H L B V V B R H H U D H H H H L B V ?
E V B D H H H H H H H H U B D U B D H H H H H H H H U B V ?
E V B B B B B B B B B B B B B B B B B B B B B B B B B B V ?
E D H H H H H H H H H H H H H H H H H H H H H H H H H H U ?
E E E E E E E E E E E E E E E E E E E E E E E E E E E E E ?
E E E E E E E E E E E E E E E E E E E E E E E E E E E E E ?